WWWWWWWWWWWWWWWWWWWWWWWWWWWWWWWWWWWWW
W                                   W
WP         C                        W
WXXXXX            X   C             W
WXXXXXXXXXXXXX X                    W
WXXXXXXXXXXXXX XXXX XXXXXXXXXXXXXXXXW
WXXXXXXXXXXXXX XXXX XXXXXXXXXXXXXXXXW