WWWWWWWWWWWWWWWWWWWWWWWWWWWWWWWWWWWWW
W                                   W
WP              C                   W
W      C       XXXX       C         W
W                                   W
WXXXXXXXXXXXX  XXXXXXXXXXXXXXXXXXXXXW
WXXXXXXXXXXXX  XXXXXXXXXXXXXXXXXXXXXW