WWWWWWWWWWWWWWWWWWWWWWWWWWWWWWWWWWWWWWWWWWWWWWWWWWWWWWWWWWWWWWWWWWWWWWWW
W                                                                      W
W                                                                      W
WP              C                                      CCCCCC          W
W      C           C      C       C     C    X        XCCCCCC          W
W                                                    XXXXXXXX          W
WXXXXXXXXXXXX  XXXXXXXXXXXXXXXXXXXXXXXXXXXXXXX   XXXXXXXXXXXXXXXXXXXXXXW
WXXXXXXXXXXXX  XXXXXXXXXXXXXXXXXXXXXXXXXXXXXXX   XXXXXXXXXXXXXXXXXXXXXXW